This file lists the abbreviations used through the code.
(Standard C, dependency and RFC-defined abbreviations are generally excluded.)

addr: address
addr4: IPv4 address
addr6: IPv6 address
be: Big Endian
cer: certificate
cert: certificate
certstack: certificate stack
ck: check (test assertion, inherited from the unit test framework)
db: database
dl: download
eof: end of file
err: error
fb: (Cached) fallback
fd: File Descriptor (see `man 2 accept`)
hdr: header
hh: hash (table) hook
ht: hash table
id: identifier
len: length
map: mapping (between a URL and a local path in the cache)
max: maximum
min: minimum
msg: message
notif: (RRDP) Notification
pdu: Protocol Data Unit (RFC 6810)
pp: Publication Point
pr: print
pfx: prefix
ptr: pointer
refget: reference get (+1 to reference counter)
refput: reference put (-1 to reference counter)
rk: Router Key
rpp: Repository Publication Point (RFC 6481)
so: Signed Object
str: string
tmp: temporal
ts: timestamp
uint: unsigned int
vrp: Validated ROA Payload (RFC 6811)
vrps: Validated ROA Payloads (VRP database)

Single-character variables are always generic counters.
